R     1920                         1080

NO ./textures/mur_bleu.xpm
WE ./textures/mur_violet.xpm
SO ./textures/wall_1.xpm
EA ./textures/bricks.xpm
S ./textures/wukong.xpm

C 250,80,0
F 200,25,30

111111111111111111111111111111111111
100000000000000000000000111111111111
111111DNN000000000000000111111111111
1110111111111111111111111111111111111111111111111
1011111111111111000000000000011111111111110000111
111111111111111100000000000001111111111100000011
111111111000000000000000001111111111100000011111
       11111111111111111111100000011111111111111
                           11111111