
R     1920 1080

NO ./map.cub

SO ./map.cub

S ./map.cub

WE ./map.cub

EA ./map.cub

C 250,80,0
F 200,25,30


          1
         111
        11011
       1100011
      110000011
     11000000011
    1100000000011
   110000000000011
  11111100000111111
       1001001
       1011101
       1000001
       1000001
       100N001
       1111111