
R     1920 1080

NO ./map.cub

SO ./map.cub

S ./map.cub

WE ./map.cub

EA ./map.cub

C 250,80,0

F 200,25,30

        1111111111111111111111111
        1000000000110000000000001
        1011000001110000002000001
        1001000000000000000000001
111111111011000001110000000000001
10000000011000001110111111111111
11110111111111011100000010001
11110111111111011101010010001
11000000110101011100000010001
10002000000000001100000010001
10000000000000001101010010001
11000000111001011111011110N0111
11110111   10101 101111010001
11111111   11111 111111111111

