
R 1280 720 

NO ./mur.xpm
WE ./mur2.xpm
SO ./mur.xpm
EA ./mur2.xpm
S ./mur.xpm

F 38,80,20
C 0,100,250

111111111111111111111111
101000000000000000000001
100000000000001111111101
101000000000001000000001
101001111000001011111101
101010000000001000000101
101110111000001111110101
101000100000000010010101
101011000000000001010101
101110000000000000110101
101100000000000000101011
101000000001110000011001
101000000001010000000101
101000000001N10000000101
101010000000000000000101
101010000000000000000101
101010000000000000000101
101101000001010000111101
100001100000000000100001
111111111111111111111111