R 1280 720

NO ./textures/mur.xpm
WE ./textures/mur2.xpm
SO ./textures/wall_1.xpm
EA ./textures/tete.xpm
S ./textures/wukong.XPM


F 36,123,45
C 0,80,250

111111111111111111111111
100000000002000000000001
100000000000001111111101
101000000000001000000001
101001111000001011111101
101010000000001000000101
101110111000001111110101
101000100000000010010101
101011000000000001010101
101110000000000000110101
101100000000000000101001
101000000000000000011001
101000000000N00000000101
101000000000000000000101
101010000000000000000101
101010000000000000000101
101010000000000000000101
101101000000000000111101
100001100000000000100001
111111111111111111111111