
R 1280 720

NO ./map.cub
SO ./map.cub
WE ./map.cub
EA ./map.cub
S ./map.cub

F 38,80,25
C 0,100,255

111111111111111111111111
101000000000000000000001
100000000000001111111101
101000000000001000000001
101001111000001011111101
101010000000001000000101
101110111000001111110101
101000100000000010010101
101011000000000001010101
101110000000000000110101
101100000000000000101011
101000000000000000011001
101000000000000000000101
101000000000N00000000101
101010000000000000000101
101010000000000000000101
101010000000000000000101
101101000001010000111101
100001100000000000100001
111111111111111111111111