R     1280 720

NO ./textures/mur_bleu.xpm

WE ./textures/mur_violet.xpm

SO ./textures/wall_1.xpm

S ./textures/wukong.xpm

EA ./textures/bricks.xpm

C 250,80,0
F 200,25,30

111111111111111111111111111111111111
10000000E0000000000000000111111111111
11111100000000000000000111111111111
1111111111111111111101111111111111111111111111111
1111111111111111000000000000011111111111110000111
1111111111111111000000000000000000000000002000011
111111111000000000000200001111111111100000011111
       11111111111111111110000000011111111111111
                         1111111111
