R 800 600

NO ./textures/mur_bleu.xpm
WE ./textures/mur_violet.xpm
SO ./textures/wall_1.xpm
EA ./textures/bricks.xpm
S ./textures/wukong.xpm


F 36,123,45
C 0,80,250

1111111111111111111111111
1000000002000000000000111
1011111100011111000110111
1011111100111111020110111
1010000000002000000000111
1000000002000000000000011
1111111111100011111111111
1111111111000001111111111
1111111111100011111111111
111111111110N011111111111
1111111111100011111111111
1111111111111111111111111
