R 800 600

NO ./textures/mur.xpm
WE ./textures/mur2.xpm
SO ./textures/wall_1.xpm
EA ./textures/bricks.xpm
S ./textures/tete.xpm


F 36,123,45
C 0,80,250

1111111111111111111111111111111111111111111111111
1000000000000000000000011111111111111111111111101
1000000000000011111111011111111111111111111111111
101000000000001000000001
101001111000001011111101
101010000002001000000101
101110111000001111110101
101000100000020010010101
101011000000000001010101
101110000000000000110101
101100000000000000101001
101000000000000000011001
101000000000N00000000101
101000002000000000000101
101010000000000000000101
101010000000000000000101
101010000002000000000101
101101000100001000111101
100001100000000000100001
111111111111111111111111